WWWWWWWWWWWWWWWWWWWWWWWWWWWWWWWWWWWWWWWWWWWWWWWWWWWWWWWWWWWWWWWWWWWWWWWWWWWWWWWWWWWWWWWWWWWWWWWWWWWWWWWWW
WWWWWWWWWWWWWWWWWWWWWWWWWWWWWWWWWWWWWWWWWWWWWWWWWWWWWWWWWWWWWWWWWWWWWWWTTTTTTTTTTTTTTTTTTTTWWWWWWWWWWWWWW
WWWWWWWWWWWWWWWWWWWWWWWWWWWWWWWWWWWWWWWWWWWWWWWWWWWWWWWWWWWWWWWWWWWWWWWTTTTTTTTTTTTTTTTTTTTWWWWWWWWWWWWWW
WWWWWWWWWWWWWWWWWWWWWWWWWWWWWWWWWWWWWWWWWWWWWWWWWWWWWWWWWWWWWWWWWWWWWWWTTTTTTTTTTTTTTTTTTTTWWWWWWWWWWWWWW
WWWWWWWWWWWWWWWWWWWWWWWWWWWWWWWWWWWWWWWWWWWWWWWWWWWWWWWWWWWWWWWWWWWWWWWTTTTTTTTTTTTTTTTTTTTWWWWWWWWWWWWWW
WWWWWWWWWWWWWWWWWWWWWWWWWWWWWWWWWWWWWWWWWWWWWWWWWWWWWWWWWWWWWWWWWWWWWWWTTTTTTTTTTTTTTTTTTTTWWWWWWWWWWWWWW
WWWWWWWWWWWWWWWWWWWWWWWWWWWWWWWWWWWWWWWWWWWWWWWWWWWWWWWWWWWWWWWWWWWWWWWTTTTTTTTTTTTTTTTTTTTWWWWWWWWWWWWWW
WTTTTTTTTTTTTTTTTV TTTTTTTTTTTTTTTTTTTTTTTTTTTWWWWWWWWWWWWWWWWWWWWWWWWWTTTTTTTTTTTTTTTTTTTTWWWWWWWWWWWWWW
WTTTTTTTTTPTTTTTT  TTTTTTTTTTTTTTTTTTTTTTTTTTTWWWWWWWWWWWWWWWWWWWWWWWWWTTTTTTTTTTTTTTTTTTTTWWWWWWWWWWWWWW
WTTTTTTTTTTTTTTTTTTTTTTTTTTTTTTTTTTTTTTTTTTTTTWWWWWWWWWWWWWWWWWWWWWWWWWTTTTTTTTTTTTTTTTTTTTWWWWWWWWWWWWWW
WTTTTTTTTTH TTTTTTTTTTTTTTTI TTTTTTTTTTTTTTTTTWWWWWWWWWWWWWWWWWWWWWWWWWTTTTTTTTTTTTTTTTTTTTWWWWWWWWWWWWWW
WTTTTTTTTT  TTTTTTTTTTTTTTT  TTTTTTTTTTTTTTTTTWWWWWWWWWWWWWWWWWWWWWWWWWTTTTTTA TTTTTTTTTTTTWWWWWWWWWWWWWW
WTTTTTTTTTTTTTTTTTTTTTTTTTTTTTTTTTTTTTTTTTTTTTWWWWWWWWWWWWWWWWWWWWWWWWWTTTTTT  TTTTTTTTTTTTWWWWWWWWWWWWWW
WWWWWWWWWWWWWWWWWWWWWWWWWTTTTTTTTTTTTTTTTTTTTTWWWWWWWWWWWWWWWWWWWWWWWWWTTTTTTTTTTTTTTTTTTTTWWWWWWWWWWWWWW
WWWWWWWWWWWWWWWWWWWWWWWWWTTTTTTTTTTTTTTTH TTTTWWWWWWWWWWWWWWWWWWWWWWWWWTTTTTTTTTTTTTTTTTTTTWWWWWWWWWWWWWW
WWWWWWWWWWWWWWWWWWWWWWWWWTTTO TTTTTTTTTT  TTTTWWWWWWWWWWWWWWWWWWWWWWWWWTTTTTTTTTTTTTTTTTTTTWWWWWWWWWWWWWW
WWWWWWWWWWWWWWWWWWWWWWWWWTTT  TTTTTTTTTTTTTTTTWWWWWWWWWWWWWWWWWWWWWWWWWTTTTTTTTTTTTTTTTTTTTWWWWWWWWWWWWWW
WWWWWWWWWWWWWWWWWWWWWWWWWTTTTTTTTTTTTTTTTTTTTTWWWWWWWWWWWWWWWWWWWWWWWWWTTTTTTTTTTTTTTTTTTTTWWWWWWWWWWWWWW
WWWWWWWWWWWWWWWWWWWWWWWWWTTTTTTTTTTTTTTTTTTTTTWWWWWWWWWWWWWWWWWWWWWWWWWTTTTTTTTTTTTTTTTTTTTWWWWWWWWWWWWWW
WWWWWWWWWWWWWWWWWWWWWWWWWTTTTTTTTTTTTTTTTTTTTTWWWWWWWWWWWWWWWWWWWWWWWWWTTTTTTTTTTTTTTTTTTTTWWWWWWWWWWWWWW
WWWWWWWWWWWWWWWWWWWWWWWWWTTTTTTTTTTTTTTTTTTTTTWWWWWWWWWWWWWWWWWWWWWWWWWTTTTTTTTTTTTTTTTTTTTWWWWWWWWWWWWWW
WWWWWWWWWWWWWWWWWWWWWWWWWWWTTTTTTTTTTTTTTTTTTTWWWWWWWWWWWWWWWWWWWWWWWWWTTTTTTTTTTTTTTTTTTTTWWWWWWWWWWWWWW
WWWWWWWWWWWWWWWWWWWWWWWWWWWWWTTTTTTTTTTTTTTTTTTTTTTTTTTTTTTTTTTTTTTTTTTTTTTTTTTTTTTTTTTTTTTWWWWWWWWWWWWWW
WWWWWWWWWWWWWWWWWWWWWWWWWWWWWTTTTTTTTTTTTTTTTTTTTTTTTTTTTTTTTTTTTTTTTTTTTTTTTTTTTTTTTTTTTTTWWWWWWWWWWWWWW
WWWWWWWWWWWWWWWWWWWWWWWWWWWWWTTTTTTTTTTTT   TTTTTTTTTTTTTTTTTTTTTTTTTTTTTTTTTTTTTTTTTTTTTTTWWWWWWWWWWWWWW
WWWWWWWWWWWWWWWWWWWWWWWWWWWWWTTTTTTTTTTTT R TTTTTTTTTTTTTTTTTTTTTTTTTTTTTTTTTTTTTTTTTTTTTTTWWWWWWWWWWWWWW
WWWWWWWWWWWWWWWWWWWWWWWWWWWWWTTTTTTTTTTTT   TTTTTTTTTTTTTTTTTTTTTTTTTTTTTTTTTTTTTTTTTTTTTTTWWWWWWWWWWWWWW
WWWWWWWWWWWWWWWWWWWWWWWWWWWWWTTTTTTTTTTTTTTTTTTTTTTTTTTTTTTTTTTTTTTTTTTTTTTTTTTTTTTTTTTTTTTWWWWWWWWWWWWWW
WWWWWWWWWWWWWWWWWWWWWWWWWWWWWTTTTTTTTTTTTTTTTTTTTTTTTTTTTTH TTTTTTTTTTTTTTTTTTTTTTTTTTTTTTTWWWWWWWWWWWWWW
WWWWWWWWWWWWWWWWWWWWWWWWWWWWWTTTTTTTTTTTTTTTTTTTTTTTTTTTTT  TTTTTTTTTTTTTTTTTTTTTTTTTTTTTTTWWWWWWWWWWWWWW
WWWWWWWWWWWWWWWWWWWWWWWWWWWWWTTTTTTTTTTTTTTTTTTTTTTTTTTTTTTTTTTTTTTTTTTTTTTTTTTTTTTTTTTTTTTWWWWWWWWWWWWWW
WWWWWWWWWWWWWWWWWWWWWWWWWWWWWTTTTTTTTTTTTTTTTTTTTTTTTTTTTTTTTTTTTTTTTTTTTTTTTTTTTTTTTTTTTTTWWWWWWWWWWWWWW
WWWWWWWWWWWWWWWWWWWWWWWWWWWWWTTTTTTTTTTTTTTTTTTTTTTTTTTTTTTTTTTTTTTTTTTTTTTTTTTTTTTTTTTTTTTWWWWWWWWWWWWWW
WWWWWWWWWWWWWWWWWWWWWWWWWWWWWWWWWWWWWWWWWWWWWWWWWWWWWWWWWWWWWWWWWWWWWWWWWWWWWWWWWWWWWWWWWWWWWWWWWWWWWWWWW