WWWWWWWWWWWWWWWWWWWWWWWWWWWWWWWWWWWWWWWWWWWWWWWWWWWWWWWWW
WWWWWWWWWWWWWWWWWWWWWWWWWWWWWWWWWWWWWWWWWWWWWWWWWWWWWWWWW
WWWWWWWWWWWWWWWWWWWWWWWWWWWWWWWWWWWWWWWWWWWWWWWWWWWWWWWWW
WWWWWWWWWWWWWWWWWWWWWWWWWWWWWWWWWWWWWWWWWWWWWWWWWWWWWWWWW
WWWWWWWWWWWWWWWWWWWWWWWWWWWWWWWWWWWWWWWWWWWWWWWWWWWWWWWWW
WWWWWWWWWWWWWWWWWWWWWWWWWWWWWWWWWWWWWWWWWWWWWWWWWWWWWWWWW
WTTTTTTTTTTTTTTTTTTTTTTTTTTTTTTTTTTTTTTTTTTTTTWWWWWWWWWWW
WTTTTTTTTTTTTTTTTTTTTTTTTTTTTTTTTTTTTTTTTTTTTTWWWWWWWWWWW
WTTTTTTTTTTTTTTTTTTTTTTTTTTTTTTTTTTTTTTTTTTTTTWWWWWWWWWWW
WTTTTTTTTTTPTTTTTTTTTTTTTTTTTTTTTTTTTTTTTTTTTTWWWWWWWWWWW
WTTTTTTTTTTTTTTTTTTTTTTTTTTTTTTTTTTTTTTTTTTTTTWWWWWWWWWWW
WTTTTTTTTTTTTTTTTTTTTTTTTTTTTTTTTTTTTTTTTTTTTTWWWWWWWWWWW
WWWWWWWWWWWWWWWWWWWWWWWWWTTTTTTTTTTTTTTTTTTTTTWWWWWWWWWWW
WWWWWWWWWWWWWWWWWWWWWWWWWTTTTTTTTTTTTTTTTTTTTTWWWWWWWWWWW
WWWWWWWWWWWWWWWWWWWWWWWWWTTTTTTTTTTTTTTTTTTTTTWWWWWWWWWWW
WWWWWWWWWWWWWWWWWWWWWWWWWTTTTTTTTTTTTTTTTTTTTTWWWWWWWWWWW
WWWWWWWWWWWWWWWWWWWWWWWWWTTTTTTTTTTTTTTTTTTTTTWWWWWWWWWWW
WWWWWWWWWWWWWWWWWWWWWWWWWTTTTTTTTTTTTTTTTTTTTTWWWWWWWWWWW
WWWWWWWWWWWWWWWWWWWWWWWWWTTTTTTTTTTTTTTTTTTTTTWWWWWWWWWWW