WWWWWWWWWWWWWWWWWWWWWWWWWWWWWWWWWWWWWWWWWWWWWWWWWWWWWWWWWWWWWWWWWWWWWWWWWWWWWWWWWWWWWWWWWWWWWWWWWWWWWWWWW
WWWWWWWWWWWWWWWWWWWWWWWWWWWWWWWWWWWWWWWWWWWWWWWWWWWWWWWWWWWWWWWWWWWWWWWTTTTTTTTTTTTTTTTTTE WWWWWWWWWWWWWW
WWWWWWWWWWWWWWWWWWWWWWWWWWWWWWWWWWWWWWWWWWWWWWWWWWWWWWWWWWWWWWWWWWWWWWWTTTTTTTTTTTTTTTTTT  WWWWWWWWWWWWWW
WWWWWWWWWWWWWWWWWWWWWWWWWWWWWWWWWWWWWWWWWWWWWWWWWWWWWWWWWWWWWWWWWWWWWWWTTTTTTTTTTTTTTTTMTTTWWWWWWWWWWWWWW
WWWWWWWWWWWWWWWWWWWWWWWWWWWWWWWWWWWWWWWWWWWWWWWWWWWWWWWWWWWWWWWWWWWWWWWTTTTTTTTTTTTTTTTTTTTWWWWWWWWWWWWWW
WWWWWWWWWWWWWWWWWWWWWWWWWWWWWWWWWWWWWWWWWWWWWWWWWWWWWWWWWWWWWWWWWWWWWWWTTTTTTTTTTTTTTTTTTTTWWWWWWWWWWWWWW
WWWWWWWWWWWWWWWWWWWWWWWWWWWWWWWWWWWWWWWWWWWWWWWWWWWWWWWWWWWWWWWWWWWWWWWTTTMTTTTTTTTTTTTTTTTWWWWWWWWWWWWWW
WTTTTTTTTTTTTTTTTV TTTTTTTTTTTTTTTTTTTTMTTTTTTWWWWWWWWWWWWWWWWWWWWWWWWWTTTTTTTTTTTTTTTTTTTTWWWWWWWWWWWWWW
WTTTTTTTTTPTTTTTT  TTTTTTTTTTTTTTTTTTTTTTTTTTTWWWWWWWWWWWWWWWWWWWWWWWWWTTTTTTTTTTTTMTTTTTTTWWWWWWWWWWWWWW
WTTTTTTTTTTTTRTTTTTTTTTTTTTTTTTTTTTTTTTTTTTTTTWWWWWWWWWWWWWWWWWWWWWWWWWTMTTTTTTTTTTTTTTTTTTWWWWWWWWWWWWWW
WTTTTTTTTTTTTTTTTTTTTTTTTTTI TTTTTTTTTTTTTTTTTWWWWWWWWWWWWWWWWWWWWWWWWWTTTTTTTTTTTTTTTTTTTTWWWWWWWWWWWWWW
WTTTTTTTTTTTTTTTTTTTTTRTTTT  TTTTTTTTTTTTTTTTTWWWWWWWWWWWWWWWWWWWWWWWWWTTTTTTA TTTTTTTTTTTTWWWWWWWWWWWWWW
WTTTTTTTTTTTTTTTTTTTTTTTTTTTTTTTTTTTTTTTTTTTTTWWWWWWWWWWWWWWWWWWWWWWWWWTTTTTT  TTTTTTMTMTTTWWWWWWWWWWWWWW
WWWWWWWWWWWWWWWWWWWWWWWWWTTTTTTTTTTTTTTTTTTTTTWWWWWWWWWWWWWWWWWWWWWWWWWTTTTTTTTTTTTTTTTTTTTWWWWWWWWWWWWWW
WWWWWWWWWWWWWWWWWWWWWWWWWTTTTTTTTTTTTTTTH TTTTWWWWWWWWWWWWWWWWWWWWWWWWWTTTTTTTTTTTTTTTTTTTTWWWWWWWWWWWWWW
WWWWWWWWWWWWWWWWWWWWWWWWWTTTO TTTTTTTTTT  TTTTWWWWWWWWWWWWWWWWWWWWWWWWWTTTTTTTTTTTTTTTTMTTTWWWWWWWWWWWWWW
WWWWWWWWWWWWWWWWWWWWWWWWWTTT  TTTTTTTTTTTTTTTTWWWWWWWWWWWWWWWWWWWWWWWWWTTTTTTTTTTTTTTTTTTTTWWWWWWWWWWWWWW
WWWWWWWWWWWWWWWWWWWWWWWWWTTTTTTTTTTTTTTTTTTTTTWWWWWWWWWWWWWWWWWWWWWWWWWTTTTTTTTTTMTTTTTTTTTWWWWWWWWWWWWWW
WWWWWWWWWWWWWWWWWWWWWWWWWTTTTTTTTTTTTTTTTTTTTTWWWWWWWWWWWWWWWWWWWWWWWWWTTTTTTTTTTTTTTTTTTTTWWWWWWWWWWWWWW
WWWWWWWWWWWWWWWWWWWWWWWWWTTTTTTTTTTTTTTTTTTTTTWWWWWWWWWWWWWWWWWWWWWWWWWTTTRTTTTTTTTTTTTTTTTWWWWWWWWWWWWWW
WWWWWWWWWWWWWWWWWWWWWWWWWTTTTTTTTTTTTTTTTTTTTTWWWWWWWWWWWWWWWWWWWWWWWWWTTTTTTTTTTTTTTTTTTTTWWWWWWWWWWWWWW
WWWWWWWWWWWWWWWWWWWWWWWWWWWTTTTTTTTTTTTTTTTTTTTTTTRTTTTTTTTTTTTTTTTTTTTTTTTTTTTTTTTTTTTTTTTWWWWWWWWWWWWWW
WWWWWWWWWWWWWWWWWWWWWWWWWWWWWTTTTTTTTTTTTTTTTTTTTTRTTTTTTTTTTTTTTTTTTTTTTTTTTTTTTTTTTTTTTTTWWWWWWWWWWWWWW
WWWWWWWWWWWWWWWWWWWWWWWWWWWWWTTTTTTTTTTTTTTTTTTTTTRTTTTTTTTTTTTTTTTTTTTTMTTTTTTTTTTTTTTTTTTWWWWWWWWWWWWWW
WWWWWWWWWWWWWWWWWWWWWWWWWWWWWTTTMTTTTTTTTTTTTTTTTTRTTTTTTTTTTTTTTTTTTTTTTTTTTTTTTTTTTTTTTTTTWWWWWWWWWWWWWW
WWWWWWWWWWWWWWWWWWWWWWWWWWWWWTTTTTTTTTTTTTTTTTTTTTTTTTTTTTTTTTTTTTTTTTTTTTTTTTTTTTTTTTTTTTTWWWWWWWWWWWWWW
WWWWWWWWWWWWWWWWWWWWWWWWWWWWWTTTTTTTTTTTTTTTTTTTTTRTTTTTTTTTTTTTTTTTTTTTTTTTTTTTTTTTTTTTTTTWWWWWWWWWWWWWW
WWWWWWWWWWWWWWWWWWWWWWWWWWWWWTTTTTTTTTTTTTTTTTTTTTTTTTTTTTTTTTTTTTTTTTTTTTTTTTTTTTTTTTTTTTTWWWWWWWWWWWWWW
WWWWWWWWWWWWWWWWWWWWWWWWWWWWWTTTTTTTTTTTTMTTTTTTTTRTTTTTTTH TTTTTTTTTTTTTTTTTTTTTTTTTTTTTTTWWWWWWWWWWWWWW
WWWWWWWWWWWWWWWWWWWWWWWWWWWWWTTTTTTTTTTTTTTTTTTTTTRTTTTTTT  TTTTTTTTTTTTTTTTTMTTTTTTTTTTTTTWWWWWWWWWWWWWW
WWWWWWWWWWWWWWWWWWWWWWWWWWWWWTTTTTTTTTTTTTTTTTTTTTRTTTTTTTTTTTTTTTTTTTTTTTTTTTTTTTTTTTTTTTTWWWWWWWWWWWWWW
WWWWWWWWWWWWWWWWWWWWWWWWWWWWWTTTTTTTTTTTTTTTTTTTTTRTTTTTTTTTTTTTTTTTTTTTTTTTTTTTTTTTTTTTTTTWWWWWWWWWWWWWW
WWWWWWWWWWWWWWWWWWWWWWWWWWWWWTTTTTTTTTTTTTTTTTTTTTRTTTTTTTTTTTTTTTTTTTTTTTTTTTTTTTTTTTTTTTTWWWWWWWWWWWWWW
WWWWWWWWWWWWWWWWWWWWWWWWWWWWWWWWWWWWWWWWWWWWWWWWWWWWWWWWWWWWWWWWWWWWWWWWWWWWWWWWWWWWWWWWWWWWWWWWWWWWWWWWW