WWWWWWWWWWWWWWWWWWWWWWWWWWWWWWWWWWWWWWWWWWWWWWWWWWWWWWWWW
WWWWWWWWWWWWWWWWWWWWWWWWWWWWWWWWWWWWWWWWWWWWWWWWWWWWWWWWW
WWWWWWWWWWWWWWWWWWWWWWWWWWWWWWWWWWWWWWWWWWWWWWWWWWWWWWWWW
WWWWWWWWWWWWWWWWWWWWWWWWWWWWWWWWWWWWWWWWWWWWWWWWWWWWWWWWW
WWWWWWWWWWWWWWWWWWWWWWWWWWWWWWWWWWWWWWWWWWWWWWWWWWWWWWWWW
WWWWWWWWWWWWWWWWWWWWWWWWWWWWWWWWWWWWWWWWWWWWWWWWWWWWWWWWW
WWWWWWWWWWWWWWWWWWWWWWWWWWWWWWWWWWWWWWWWWWWWWWWWWWWWWWWWW
WTTTTTTTTTTTTTTTTTTTTTTTTTTTTTTTTTTTTTTTTTTTTTWWWWWWWWWWW
WTTTTTTTTTPTTTTTTTTTTTTTTTTTTTTTTTTTTTTTTTTTTTWWWWWWWWWWW
WTTTTTTTTTTTTTTTTTTTTTTTTTTTTTTTTTTTTTTTTTTTTTWWWWWWWWWWW
WTTTTTTTTTTTTTTTTTTTTTTTTTTL TTTTTTTTTTTTTTTTTWWWWWWWWWWW
WTTTTTTTTTTTTTTTTTTTTTTTTTT  TTTTTTTTTTTTTTTTTWWWWWWWWWWW
WTTTTTTTTTTTTTTTTTTTTTTTTTTTTTTTTTTTTTTTTTTTTTWWWWWWWWWWW
WWWWWWWWWWWWWWWWWWWWWWWWWTTTTTTTTTTTTTTTTTTTTTWWWWWWWWWWW
WWWWWWWWWWWWWWWWWWWWWWWWWTTTTTTTTTTTTTTTTTTTTTWWWWWWWWWWW
WWWWWWWWWWWWWWWWWWWWWWWWWTTTTTTTTTTTTTTTTTTTTTWWWWWWWWWWW
WWWWWWWWWWWWWWWWWWWWWWWWWTTTTTTTTTTTTTTTTTTTTTWWWWWWWWWWW
WWWWWWWWWWWWWWWWWWWWWWWWWTTTTTTTTTTTTTTTTTTTTTWWWWWWWWWWW
WWWWWWWWWWWWWWWWWWWWWWWWWTTTTTTTTTTTTTTTTTTTTTWWWWWWWWWWW
WWWWWWWWWWWWWWWWWWWWWWWWWTTTTTTTTTTTTTTTTTTTTTWWWWWWWWWWW