WWWWWWWWWWWWWWWWWWWWWWWWWWWWWWWWWWWWWWWWWWWWWWWWWWWWWWWWWWWWWWWWWWWWWWWWWWWWWWWWWWWWWWWWWWWWWWWWWWWWWWWWW
WWWWWWWWWWWWWWWWWWWWWWWWWWWWWWWWWWWWWWWWWWWWWWWWWWWWWWWWWWWWWWWWWWWWWWWTTTTTTTTTTTTTTTTTTTTWWWWWWWWWWWWWW
WWWWWWWWWWWWWWWWWWWWWWWWWWWWWWWWWWWWWWWWWWWWWWWWWWWWWWWWWWWWWWWWWWWWWWWTTTTTTTTTTTTTTTTTTTTWWWWWWWWWWWWWW
WWWWWWWWWWWWWWWWWWWWWWWWWWWWWWWWWWWWWWWWWWWWWWWWWWWWWWWWWWWWWWWWWWWWWWWTTTTTTTTTTTTTTTTMTTTWWWWWWWWWWWWWW
WWWWWWWWWWWWWWWWWWWWWWWWWWWWWWWWWWWWWWWWWWWWWWWWWWWWWWWWWWWWWWWWWWWWWWWTTTTTTTTTTTTTTTTTTTTWWWWWWWWWWWWWW
WWWWWWWWWWWWWWWWWWWWWWWWWWWWWWWWWWWWWWWWWWWWWWWWWWWWWWWWWWWWWWWWWWWWWWWTTTTTTTTTTTTTTTTTTTTWWWWWWWWWWWWWW
WWWWWWWWWWWWWWWWWWWWWWWWWWWWWWWWWWWWWWWWWWWWWWWWWWWWWWWWWWWWWWWWWWWWWWWTTTMTTTTTTTTTTTTTTTTWWWWWWWWWWWWWW
WTTTTTTTTTTTTTTTTV TTTTTTTTTTTTTTTTTTTTMTTTTTTWWWWWWWWWWWWWWWWWWWWWWWWWTTTTTTTTTTTTTTTTTTTTWWWWWWWWWWWWWW
WTTTTTTTTTPTTTTTT  TTTTTTTTTTTTTTTTTTTTTTTTTTTWWWWWWWWWWWWWWWWWWWWWWWWWTTTTTTTTTTTTMTTTTTTTWWWWWWWWWWWWWW
WTTTTTTTTTTTTTTTTTTTTTTTTTTTTTTTTTTTTTTTTTTTTTWWWWWWWWWWWWWWWWWWWWWWWWWTMTTTTTTTTTTTTTTTTTTWWWWWWWWWWWWWW
WTTTTTTTTTTTTTTTTTTTTTTTTTTI TTTTTTTTTTTTTTTTTWWWWWWWWWWWWWWWWWWWWWWWWWTTTTTTTTTTTTTTTTTTTTWWWWWWWWWWWWWW
WTTTTTTTTTTTTTTTTTTTTTTTTTT  TTTTTTTTTTTTTTTTTWWWWWWWWWWWWWWWWWWWWWWWWWTTTTTTA TTTTTTTTTTTTWWWWWWWWWWWWWW
WTTTTTTTTTTTTTTTTTTTTTTTTTTTTTTTTTTTTTTTTTTTTTWWWWWWWWWWWWWWWWWWWWWWWWWTTTTTT  TTTTTTMTMTTTWWWWWWWWWWWWWW
WWWWWWWWWWWWWWWWWWWWWWWWWTTTTTTTTTTTTTTTTTTTTTWWWWWWWWWWWWWWWWWWWWWWWWWTTTTTTTTTTTTTTTTTTTTWWWWWWWWWWWWWW
WWWWWWWWWWWWWWWWWWWWWWWWWTTTTTTTTTTTTTTT  TTTTWWWWWWWWWWWWWWWWWWWWWWWWWTTTTTTTTTTTTTTTTTTTTWWWWWWWWWWWWWW
WWWWWWWWWWWWWWWWWWWWWWWWWTTTO TTTTTTTTTT  TTTTWWWWWWWWWWWWWWWWWWWWWWWWWTTTTTTTTTTTTTTTTMTTTWWWWWWWWWWWWWW
WWWWWWWWWWWWWWWWWWWWWWWWWTTT  TTTTTTTTTTTTTTTTWWWWWWWWWWWWWWWWWWWWWWWWWTTTTTTTTTTTTTTTTTTTTWWWWWWWWWWWWWW
WWWWWWWWWWWWWWWWWWWWWWWWWTTTTTTTTTTTTTTTTTTTTTWWWWWWWWWWWWWWWWWWWWWWWWWTTTTTTTTTTMTTTTTTTTTWWWWWWWWWWWWWW
WWWWWWWWWWWWWWWWWWWWWWWWWTTTTTTTTTTTTTTTTTTTTTWWWWWWWWWWWWWWWWWWWWWWWWWTTTTTTTTTTTTTTTTTTTTWWWWWWWWWWWWWW
WWWWWWWWWWWWWWWWWWWWWWWWWTTTTTTTTTTTTTTTTTTTTTWWWWWWWWWWWWWWWWWWWWWWWWWTTTRTTTTTTTTTTTTTTTTWWWWWWWWWWWWWW
WWWWWWWWWWWWWWWWWWWWWWWWWTTTTTTTTTTTTTTTTTTTTTWWWWWWWWWWWWWWWWWWWWWWWWWTTTTTTTTTTTTTTTTTTTTWWWWWWWWWWWWWW
WWWWWWWWWWWWWWWWWWWWWWWWWWWTTTTTTTTTTTTTTTTTTTWWWWWWWWWWWWWWWWWWWWWWWWWTTTTTTTTTTTTTTTTTTTTWWWWWWWWWWWWWW
WWWWWWWWWWWWWWWWWWWWWWWWWWWWWTTTTTTTTTTTTTTTTTTTTTTTTTTTTTTTTTTTTTTTTTTTTTTTTTTTTTTTTTTTTTTWWWWWWWWWWWWWW
WWWWWWWWWWWWWWWWWWWWWWWWWWWWWTTTTTTTTTTTTTTTTTTTTTTTTTTTTTTTTTTTTTTTTTTTMTTTTTTTTTETTTTTTTTWWWWWWWWWWWWWW
WWWWWWWWWWWWWWWWWWWWWWWWWWWWWTTTMTTTTTTTTTTTTTTTTTTTTTTTTTTTTTTTTTTTTTTTTTTTTTTTTTTTTTTTTTTWWWWWWWWWWWWWW
WWWWWWWWWWWWWWWWWWWWWWWWWWWWWTTTTTTTTTTTTTTTTTTTTTTTTTTTTTTTTTTTTTTTTTTTTTTTTTTTTTTTTTTTTTTWWWWWWWWWWWWWW
WWWWWWWWWWWWWWWWWWWWWWWWWWWWWTTTTTTTTTTTTTTTTTTTTTTTTTTTTTTTTTTTTTTTTTTTTTTTTTTTTTTTTTTTTTTWWWWWWWWWWWWWW
WWWWWWWWWWWWWWWWWWWWWWWWWWWWWTTTTTTTTTTTTTTTTTTTTTTTTTTTTTTTTTTTTTTTTTTTTTTTTTTTTTTTTTTTTTTWWWWWWWWWWWWWW
WWWWWWWWWWWWWWWWWWWWWWWWWWWWWTTTTTTTTTTTTMTTTTTTTTTTTTTTTT  TTTTTTTTTTTTTTTTTTTTTTTTTTTTTTTWWWWWWWWWWWWWW
WWWWWWWWWWWWWWWWWWWWWWWWWWWWWTTTTTTTTTTTTTTTTTTTTTTTTTTTTT  TTTTTTTTTTTTTTTTTMTTTTTTTTTTTTTWWWWWWWWWWWWWW
WWWWWWWWWWWWWWWWWWWWWWWWWWWWWTTTTTTTTTTTTTTTTTTTTTTTTTTTTTTTTTTTTTTTTTTTTTTTTTTTTTTTTTTTTTTWWWWWWWWWWWWWW
WWWWWWWWWWWWWWWWWWWWWWWWWWWWWTTTTTTTTTTTTTTTTTTTTTTTTTTTTTTTTTTTTTTTTTTTTTTTTTTTTTTTTTTTTTTWWWWWWWWWWWWWW
WWWWWWWWWWWWWWWWWWWWWWWWWWWWWTTTTTTTTTTTTTTTTTTTTTTTTTTTTTTTTTTTTTTTTTTTTTTTTTTTTTTTTTTTTTTWWWWWWWWWWWWWW
WWWWWWWWWWWWWWWWWWWWWWWWWWWWWWWWWWWWWWWWWWWWWWWWWWWWWWWWWWWWWWWWWWWWWWWWWWWWWWWWWWWWWWWWWWWWWWWWWWWWWWWWW