WWWWWWWWWWWWWWWWWWWWWWWWWWWWWWWWWWWWWWWWWWWWWWWWWWWWWWWWW
WWWWWWWWWWWWWWWWWWWWWWWWWWWWWWWWWWWWWWWWWWWWWWWWWWWWWWWWW
WWWWWWWWWWWWWWWWWWWWWWWWWWWWWWWWWWWWWWWWWWWWWWWWWWWWWWWWW
WWWWWWWWWWWWWWWWWWWWWWWWWWWWWWWWWWWWWWWWWWWWWWWWWWWWWWWWW
WWWWWWWWWWWWWWWWWWWWWWWWWWWWWWWWWWWWWWWWWWWWWWWWWWWWWWWWW
WWWWWWWWWWWWWWWWWWWWWWWWWWWWWWWWWWWWWWWWWWWWWWWWWWWWWWWWW
WWWWWWWWWWWWWWWWWWWWWWWWWWWWWWWWWWWWWWWWWWWWWWWWWWWWWWWWW
WTTTTTTTTTTTTTTTTTTTTTTTTTTTTTTTTTTTTTTTTTTTTTWWWWWWWWWWW
WTTTTTTTTTPTTTTTTTTTTTTTTTTTTTTTTTTTTTTTTTTTTTWWWWWWWWWWW
WTTTTTTTTTTTTTTTTTTTTTTTTTTTTTTTTTTTTTTTTTTTTTWWWWWWWWWWW
WTTTTTTTTTTTTTTTTTTTTTTTTTTI TTTTTTTTTTTTTTTTTWWWWWWWWWWW
WTTTTTTTTTTTTTTTTTTTTTTTTTT  TTTTTTTTTTTTTTTTTWWWWWWWWWWW
WTTTTTTTTTTTTTTTTTTTTTTTTTTTTTTTTTTTTTTTTTTTTTWWWWWWWWWWW
WWWWWWWWWWWWWWWWWWWWWWWWWTTTTTTTTTTTTTTTTTTTTTWWWWWWWWWWW
WWWWWWWWWWWWWWWWWWWWWWWWWTTTTTTTTTTTTTTTTTTTTTWWWWWWWWWWW
WWWWWWWWWWWWWWWWWWWWWWWWWTTTO TTTTTTTTTTTTTTTTWWWWWWWWWWW
WWWWWWWWWWWWWWWWWWWWWWWWWTTT  TTTTTTTTTTTTTTTTWWWWWWWWWWW
WWWWWWWWWWWWWWWWWWWWWWWWWTTTTTTTTTTTTTTTTTTTTTWWWWWWWWWWW
WWWWWWWWWWWWWWWWWWWWWWWWWTTTTTTTTTTTTTTTTTTTTTWWWWWWWWWWW
WWWWWWWWWWWWWWWWWWWWWWWWWTTTTTTTTTTTTTTTTTTTTTWWWWWWWWWWW